####################################################################################################
!                                          #                                                       #
!                                          #                                                       #
!                                          #                                                       #
# #############    ##########              #                   #############                       #
#                                          #                                                       #
#                               ############                                                       #
#                               #                                                                  #
#                               #                                                                  #
#                               #                                                                  #
#                               #                                                                  #
#                               #                                                                  #
#        ########################                             #############                        #
#                                                                                                  #
#                                                                                                  #
#                                                                                                  #
#                                                                                                  #
#          ###################                     #############                                   #
#                            #                     #           #                                   #
#                            #                     #           #                                   #
#                            #                     #           #                                   #
#                            #                     #           #                                   #
#                            #                     #           #                                   #
##########################################         #           #                                   #
#                                        #                     #                                   #
#                                        #                     #                                   #
#                                        #                     #                                   #
#                                        #                     #                                   #
#                                        # #####################################                   #
#                                                                                                  #
#                                                                                                  #
#                                                                                                  #
#                                    ###############################################################
#                                    #                                                             #
#                                    #                                                             #
#                                    #                                                             #
#                                    #                                                             #
#                                    #                                                             #
#                                    #                                                             #
#                                    #                                                             ?
#                                                                                                  ?
#                                                                                                  ?
#                                                                                                  #
#                                                                                                  #
####################################################################################################