####################################################################################################
!                                                                                                  #
!                                                                                                  #
!                                                                                                  #
# ###################################################################################              #
#                                                                                                  #
#                                                                                                  #
#                                                                                                  #
#                ###################################################################################
#                               #                                    #                             #
#                               #                                    #                             #
#                               #                                    #                             #
#        ########################        ###############      #############                        #
#                                                      #                                           #
#                                                      #                                           #
#                                                      #                                           #
#                                                      #                                           #
#          ##############################################################                          #
#                            #                     #           #                                   #
#                            #                     #           #                                   #
#                            #                     #                                               #
#                            #                     #                                               #
#                            #                     #                                               #
##########################################         #           #####################################
#                                                              #                                   #
#                                                              #                                   #
#                                                              #                                   #
#                                                              #                                   #
#         ######################################################################                   #
#                                                                                                  #
#                                                                                                  #
#                                                                                                  #
#                                    #######################################################   #####
#                                    #                            #                                #
#                                    #                            #                                #
#                                    #                            #                                #
#                                    #                            #          #######################
#      ############                  #                                       #                     #
#                                    #                                       #                     #
#                                    #                                       #                     ?
#                         ###################################################                      ?
#                                                                                                  ?
#                                                                                                  #
#                                                                                                  #
####################################################################################################