####################################################################################################
!                                                                                                  #
!                                                                                                  #
!                                                                                                  #
# ###################################################################################              #
#                                          #                                                       #
#                               ############                                                       #
#                               #                                                                  #
#                               #                                    ###############################
#                               #                                    #                             #
#                               #                                    #                             #
#                               #                                    #                             #
#        ########################        ###############      #############                        #
#                                                      #                                           #
#                                                      #                                           #
#                                                      #                                           #
#                                                      #                                           #
#          ###################                     #############                                   #
#                            #                     #           #                                   #
#                            #                     #           #                                   #
#                            #                     #           #                                   #
#                            #                     #           #                                   #
#                            #                     #           #                                   #
##########################################         #           #####################################
#                                                              #                                   #
#                                                              #                                   #
#                                                              #                                   #
#                                                              #                                   #
#                                        # #####################################                   #
#                                                                                                  #
#                                                                                                  #
#                                                                                                  #
#                                    ###############################################################
#                                    #                            #                                #
#                                    #                            #                                #
#                                    #                            #                                #
#                                    #                            #                                #
#      ############                  #                                                             #
#                                    #                                                             #
#                                    #                                                             ?
#                         ############                            #                                ?
#                                                                 #                                ?
#                                                                 #                                #
#                                                                 #                                #
####################################################################################################