####################################################################################################
!                                          #                                                       #
!                                          #                                                       #
!                                          #                                                       #
# #############    ##########              #                   #############                       #
#                                          #                   #                                   #
#                               ############                   #                                   #
#                                                              #                                   #
#                                                              #                                   #
#                                                              #                                   #
#                               #                              #                                   #
#                               #                              #                                   #
#        #########################################################                                 #
#                                                                                                  #
#                                                                                                  #
#                                                                                                  #
#                                                                                                  #
#          ###################                     #############                                   #
#                            #                     #           #                                   #
#                            #                     #           #                                   #
#                            #                     #           #                                   #
#                            #                     #           ################################    #
#                            #                     #           #                                   #
##########################################         #           #                                   #
#                                        #                     #                                   #
#                                        #                     #                                   #
#              #                         #                     #                                   #
#              #                         #                     #                                   #
#              #                         # #####################################                   #
#              #                                                                                   #
#              #                                                                                   #
#              #                                                                                   #
#              #                     ###############################################################
#              #                     #                                                             #
#              #                     #                                                             #
#              #                     #                                                             #
#              #######################                                                             #
#                                    #                                                             #
#                                    #                                                             #
#                                    #                                                             ?
#                                                                                                  ?
#                                                                                                  ?
#                                                                                                  #
#                                                                                                  #
####################################################################################################