####################################################################################################
!                                                                                                  #
!                                                                                                  #
!                                                                                                  #
# ######################                                           ##################              #
#                                          #                                                       #
#                               ############                                                       #
#                               #                                                                  #
#                               #                                    ###############################
#                               #                                    #                             #
#                               #                                    #                             #
#                               #                                    #                             #
#        ########################        ###############      #############                        #
#                                                      #                                           #
#                                                      #                                           #
#                                                      #                                           #
#                                                      #                                           #
#          ###################                     #############                                   #
#                            #                     #           #                                   #
#                            #                     #           #                                   #
#                            #                     #           #                                   #
#                            #                     #           #                                   #
#                            #                     #           #                                   #
############                 #############         #           #####################################
#                                                              #                                   #
#                                                              #                                   #
#                                                              #                                   #
#                                                              #                                   #
#                                        #######################################                   #
#                                                                                                  #
#                 # #####################                                                          #
#                 #                                                                                #
#                 #                  ###########             #######################################
#                 #                  #                            #                                #
#                 #                  #                            #                                #
#                 #                  #                            #                                #
#                 #                  #                            #                                #
#      ############                  #                                                             #
#                                    #                                                             #
#                                    #                                                             ?
#                         ############                            #                                ?
#                                                                 #                                ?
#                                                                 #                                #
#                                                                 #                                #
####################################################################################################