####################################################################################################
!                                                                                                  #
!                                                        #                                         #
!                                                        #                                         #
# ######################                                 #         ##################              #
#                                                        #                                         #
#                               ############             #                                         #
#                               #                        #                                         #
#       ################        #                                    ###############################
#                               #                                    #                             #
#                               #                                    #                             #
#                               #                                    #                             #
#        #####              #####        ###############      #############                        #
#                                                      #                                           #
#                                                      #                                           #
#                                                      #                                           #
#                                                      #                                           #
#          ###################                     #############                                   #
#                            #                     #           #                                   #
#                            #                     #           #                                   #
#                            #                     #           #                                   #
#                            #                     #           #                                   #
#                            #                     #           #                                   #
############                 #############         #           #####################################
#                                                              #                                   #
#                                                              #                                   #
#                                                              #                                   #
#       ###############                                        #                                   #
#                                       ########################################                   #
#                                       #                                                          #
#                 # #####################                                                          #
#                 #                                                                                #
#                 #                                          ################              #########
#                 #                                               #                                #
#                 #                  #                            #                                #
#                 #                  #                            #                                #
#                 #                  #                            #                                #
#      ############                  #                                                             #
#                                    #                                                             #
#                                    #                                                             ?
#                         ############                            #                                ?
#                                                                 #                                ?
#                                    #                            #                                #
#                                                                 #                                #
####################################################################################################