####################################################################################################
!                                                                                                  #
!                                                        #                                         #
!                                                        #                                         #
# ######################                                 #         ##################              #
#                      #                                 #                                         #
#                      #        ############             #                                         #
#                      #        #                        #                                         #
#                      #        #                        #############################    ##########
#                      #        #                                    #                             #
#                      #        #                                    #                             #
#                      #        #                                    #                             #
#        #####         ##########        ###############      #############                        #
#                                                      #                                           #
#                                                      #                                           #
#                                                      #                                           #
#                                                      #                                           #
#          ###################                     #############                                   #
#                            #                     #           #                                   #
#                            #                     #                                               #
#                            #                     #                                               #
#                            #                     #                                               #
#                            #                     #           #                                   #
############                 #######################           #####################################
#                                                              #                                   #
#                                                              #                                   #
#                                                              #                                   #
#       ###############                                        #                                   #
#                     #                 ########################################                   #
#                     #                 #                                                          #
#                 # #####################                                                          #
#                 #                                                                                #
#                 #                                            ##############              #########
#                 #                                               #                                #
#                 #                  #######################      #                                #
#                 #                  #                            #                                #
#                 #                  #                            #                                #
#      ############                  #                            #                                #
#                                    #                            #                  ###############
#                                    #                            #                                ?
#                         ############                            #                                ?
#                                    #                            #                                ?
#                                    #                            #                                #
#                                    #                            #                                #
####################################################################################################