####################################################################################################
!                           #                                                                      #
!                           #                                                                      #
!                           #                                                                      #
# #############    ##########              ####################################                    #
#             #    #                       #                                  #                    #
#             #    #            ############                                  #                    #
#             #    #            #                                             #                    #
#             #    ######       #                                             #                    #
#             #                 #                                             #                    #
#             #                 #                                             #                    #
#             #                 #                                             #                    #
#        ########################                             #################                    #
#                                                                                                  #
#                                                                                                  #
#                                                                                                  #
#                                                                                                  #
#          ###################                     #################################################
#                            #                     #           #                                   #
#                            #                     #           #                                   #
#                            #                     #           #                                   #
#                            #                     #           #                                   #
#                            #                     #           #                                   #
#####   ##################################         #           #                                   #
#                                        #                     #                                   #
#                                        #                                                         #
#                                        #                                                         #
#                                        #                                                         #
#                                        # #####################################                   #
#                                                                                                  #
#                                                                                                  #
#                                                                                                  #
#                                    ###############################################################
#                                    #                                                             #
#       ##############################                                                             #
#       #                            #                                                             #
#       #                            #                                                             #
#       #                            #                                                             #
#       #                            #                                                             #
#       ######                       #                                                             ?
#                                                                                                  ?
#                                                                                                  ?
#                                                                                                  #
#                                                                                                  #
####################################################################################################