####################################################################################################
!        #                                                                                         #
!        #                                                                                         #
!        #                                                                                         #
#        #                                                         ##################              #
#        #                                 #                                                       #
#        #                      ############                                                       #
#        #                      #                                                                  #
#        #                      #                                    ###############################
#        #                      #                                    #                             #
#        #                      #                                    #                             #
#        #                      #                                    #                             #
#        ########################        ###############      #############                        #
#                                                      #                                           #
#                                                      #                                           #
#                                                      #                                           #
#                                                      #                                           #
# ###############################                  #############                                   #
#                            #                     #           #                                   #
#                            #                     #           #                                   #
#                            #                     #                                               #
#                            #                     #                                               #
#                            #                     #                                               #
############                 #######################           #####################################
#                                                              #                                   #
#                                                              #                                   #
#                                                              #                                   #
#                                                              #                                   #
#                                       ########################################                   #
#                                       #                                                          #
#                 # #####################                                                          #
#                 #                                                                                #
#                 #                                          #######################################
#                 #                                               #                                #
#                 #                  #########                    #                                #
#                 #                  #                            #                                #
#                 #                  #                            #                                #
#      ############                  #                                                             #
#                                    #                                                             #
#                                    #                                                             ?
#                         ############                            #                                ?
#                         #                                       #                                ?
#                         #                                       #                                #
#                         #                                       #                                #
####################################################################################################