####################################################################################################
!        #                                 #                                                       #
!        #                                 #                                                       #
!        #                                 #                                                       #
#        #                                 #                       ##################              #
#        #                                 #                                                       #
#        #                      ########   ############                                            #
#        #                      #                                                                  #
#        #                      #                                    ###############################
#                               #                                    #                             #
#                               #                                    #                             #
#                               #                                    #                             #
#################################        ###############      #############                        #
#                                                      #                                           #
#                                                      #                                           #
#                                                      #                                           #
#                                                      #                                           #
# ###############################                  ###################################             #
#                            #                     #           #                                   #
#                            #                     #           #                                   #
#                                                  #                                               #
#                                                  #                                               #
#                                                  #                                               #
############                 #######################           ###############################   ###
#                                       #                      #                                   #
#                                       #                      #                                   #
#                                       #                      #                                   #
#                                       #                      #                                   #
#                                       ########################################                   #
#                                       #                                                          #
#                 # #####################                                                          #
#                 #                  #                                                             #
#                 #                  ###########             #######################################
#                 #                  #         #                  #                                #
#                 #                  #         #                  #                                #
#                 #                  #         #                  #                                #
#                 #                  #                  ###########                                #
#      ############                  #                  #                                          #
#                                    #                  #                                          #
#                                    #                  #                                          ?
#                         ############                  #         #                                ?
#                         #                                       #                                ?
#                         #                                       #                                #
#                         #                                       #                                #
####################################################################################################